1111111
1C10001
1P001E1
1111111