1111111
10C0001
1C10001
10P01E1
1111111
1000001
1111111