1111111111111111111111111111111111111111111111111111111111111
1PE0000000000000000000000000000000000000000000000000000000001
1C00111111111111111111111111111111111111111111111111100000001
1111111111111111111111111111111111111111111111111111111111111