1111111
1C10001
10P01E1
1111111