111111111111111111111111
10C000000000000000000001
1C1000000000000000000001
10P0000000000000000001E1
111111111111111111111111
100000000000000000000001
100000000000000000000001
100000000000000000000001
111111111111111111111111