11111111111111111111
1P0000100000000000C1
11111010111111111101
1C000000100000001001
10111111101111101011
10100000001C00100001
10101111111110111101
100010000000000C0001
11101011111111111111
1C0010100000000000E1
10111000111111111111
11111111111111111111