11111111111111111111
1P0100C10001C0000001
10111011110101110001
100C0000C0000000E111
111111111111000000C1
11111111111111111111