111111111
1CC11P111
1CCCCCCC1
1CCCCCCC1
1CCCCCCC1
1CCCCCCC1
1CCCCCCC1
1CCCCCCC1
1CCCCCCC1
1CCCCCCC1
1CCCCCCC1
1CCCCCCC1
1CCCCCCC1
1CCCCCCC1
1CCCCCCC1
1CCCCCCC1
1CCCCCCC1
1CCCCCCC1
1CCCCCCC1
1CCCCCCC1
1CCCCCCC1
1CCCCCCC1
1CCCCCCC1
1CCCCCCC1
1CCCCCCC1
1CCCCCCC1
1CCCCCCC1
1CCCCCCC1
1CCCCCCC1
1CCCCCCC1
1CCCCCCC1
1CCCECCC1
111111111
