11111111111111111111111111111111111111111111111111111111111111111111111111111111111111111111111111111111111111111111111111
1P0100C10001C0000000000000000000000000000000000000000000000000000000000000000000000000000000000000000000000000000000000001
10000000000000000000000000000000000000000000000000000000000000000000000000000000000000000000000000000000000000000000000001
100C0000C00E00000000000000000000000000000000000000000000000000000000000000000000000000000000000000000000000000000000000011
11111111111100000000000000000000000000000000000000000000000000000000000000000000000000000000000000000000000000000000000001
11111111111111111111111111111111111111111111111111111111111111111111111111111111111111111111111111111111111111111111111111