1111111
1C 0011
1P001E1
1111111