1111111
1C00111
1P001E1
1111111