1111111
1C00111
1111111
1PC00E1
1111111