
1111111
1C00001
1011101
1P001E1
1111111