111111111111111111111111111111111111111111111111111111111111111111111111111111111111111111111111111111111111111111111111111
1PE000000000000000000000000000000000000000000000000000000000000000000000000000000000000000000000000000000000000000000111111
1C0000000000000000000000000000000000000000000000000000000000000000000000000000000000000000000000000000000000000000000111111
111111111111111111111111111111111111111111111111111111111111111111111111111111111111111111111111111111111111111111111111111