1111111
1C10011
1P001E1
1111111